rank,name,team,pos,gp,goals,assists,points,ppg
1,Connor McDavid,EDM,C,82,30,70,100,1.22
2,Sidney Crosby,PIT,C,75,44,45,89,1.19
3,Patrick Kane,CHI,RW,82,34,55,89,1.09
4,Nicklas Backstrom,WAS,C,82,23,63,86,1.05
5,Brad Marchand,BOS,LW,80,39,46,85,1.06
6,Nikita Kucherov,TB,RW,74,40,45,85,1.15
7,Mark Scheifele,WPG,C,79,32,50,82,1.04
8,Leon Draisaitl,EDM,C,82,29,48,77,0.94
9,Brent Burns,SJ,D,82,29,47,76,0.93
10,Vladimir Tarasenko,STL,RW,82,39,36,75,0.91
11,Blake Wheeler,WPG,RW,82,26,48,74,0.90
12,Artemi Panarin,CHI,LW,82,31,43,74,0.90
13,Ryan Getzlaf,ANH,C,74,15,58,73,0.99
14,Evgeni Malkin,PIT,C,62,33,39,72,1.16
15,Tyler Seguin,DAL,C,82,26,46,72,0.88
16,Victor Hedman,TB,D,79,16,56,72,0.91
17,Erik Karlsson,OTT,D,77,17,54,71,0.92
18,Phil Kessel,PIT,RW,82,23,47,70,0.85
19,David Pastrnak,BOS,RW,75,34,36,70,0.93
20,Alex Ovechkin,WAS,LW,82,33,36,69,0.84
21,Mikael Granlund,MIN,C,81,26,43,69,0.85
22,Auston Matthews,TOR,C,82,40,29,69,0.84
23,Jamie Benn,DAL,LW,77,26,43,69,0.90
24,Joe Pavelski,SJ,C,81,29,39,68,0.84
25,Henrik Zetterberg,DET,LW,82,17,51,68,0.83
26,Max Pacioretty,MON,LW,81,35,32,67,0.83
27,John Tavares,NYI,C,77,28,38,66,0.86
28,Jeff Carter,LA,C,82,32,34,66,0.80
29,Eric Staal,MIN,C,82,28,37,65,0.79
30,Patrik Laine,WPG,RW,73,36,28,64,0.88
31,Nikolaj Ehlers,WPG,LW,82,25,39,64,0.78
32,Jeff Skinner,CAR,LW,79,37,26,63,0.80
33,Cam Atkinson,CLS,RW,82,35,27,62,0.76
34,James van Riemsdyk,TOR,LW,82,29,33,62,0.76
35,Jakub Voracek,PHI,RW,82,20,41,61,0.74
36,Viktor Arvidsson,NSH,LW,80,31,30,61,0.76
37,Johnny Gaudreau,CGY,LW,72,18,43,61,0.85
38,Ryan Johansen,NSH,C,82,14,47,61,0.74
39,Nazem Kadri,TOR,C,82,32,29,61,0.74
40,Mitchell Marner,TOR,C,77,19,42,61,0.79
41,William Nylander,TOR,C,81,22,39,61,0.75
42,Mike Hoffman,OTT,LW,74,26,35,61,0.82
43,Evgeny Kuznetsov,WAS,C,82,19,40,59,0.72
44,Alexander Wennberg,CLS,C,80,13,46,59,0.74
45,Mats Zuccarello,NYR,RW,80,15,44,59,0.74
46,Jonathan Toews,CHI,C,72,21,37,58,0.81
47,Claude Giroux,PHI,C,82,14,44,58,0.71
48,Ryan Kesler,ANH,C,82,22,36,58,0.71
49,Filip Forsberg,NSH,LW,82,31,27,58,0.71
50,Mikko Koivu,MIN,C,80,18,40,58,0.73
51,Sean Monahan,CGY,C,82,27,31,58,0.71
52,Marcus Johansson,WAS,LW,82,24,34,58,0.71
53,Nino Niederreiter,MIN,RW,82,25,32,57,0.70
54,Jack Eichel,BUF,C,61,24,33,57,0.93
55,Charlie Coyle,MIN,C,82,18,38,56,0.68
56,Kevin Shattenkirk,WAS,D,80,13,43,56,0.70
57,Josh Bailey,NYI,LW,82,13,43,56,0.68
58,T.J. Oshie,WAS,RW,68,33,23,56,0.82
59,J.T. Miller,NYR,LW,82,22,34,56,0.68
60,Derek Stepan,NYR,C,81,17,38,55,0.68
61,Radim Vrbata,ARI,RW,81,20,35,55,0.68
62,Brayden Schenn,PHI,C,79,25,30,55,0.70
63,Tyler Bozak,TOR,C,78,18,37,55,0.71
64,Jaden Schwartz,STL,LW,78,19,36,55,0.71
65,Ryan O'Reilly,BUF,C,72,20,35,55,0.76
66,Kyle Turris,OTT,C,78,27,28,55,0.71
67,Mark Stone,OTT,RW,71,22,32,54,0.76
68,David Krejci,BOS,C,82,23,31,54,0.66
69,Vincent Trocheck,FLA,C,82,23,31,54,0.66
70,Alexander Radulov,MON,RW,76,18,36,54,0.71
71,Wayne Simmonds,PHI,RW,82,31,23,54,0.66
72,Kyle Palmieri,NJ,RW,80,26,27,53,0.66
73,Duncan Keith,CHI,D,80,6,47,53,0.66
74,Taylor Hall,NJ,LW,72,20,33,53,0.74
75,Mikael Backlund,CGY,C,81,22,31,53,0.65
76,Conor Sheary,PIT,LW,61,23,30,53,0.87
77,Corey Perry,ANH,RW,82,19,34,53,0.65
78,Patrice Bergeron,BOS,C,79,21,32,53,0.67
79,Brandon Saad,CLS,LW,82,24,29,53,0.65
80,Nathan MacKinnon,COL,C,82,16,37,53,0.65
81,Chris Kreider,NYR,LW,75,28,25,53,0.71
82,Jonathan Drouin,TB,LW,73,21,32,53,0.73
83,Bo Horvat,VAN,C,81,20,32,52,0.64
84,Logan Couture,SJ,C,73,25,27,52,0.71
85,Anze Kopitar,LA,C,76,12,40,52,0.68
86,Anders Lee,NYI,LW,81,34,18,52,0.64
87,Ondrej Palat,TB,LW,75,17,35,52,0.69
88,Dustin Byfuglien,WPG,D,80,13,39,52,0.65
89,Aleksander Barkov,FLA,C,61,21,31,52,0.85
90,Torey Krug,BOS,D,81,8,43,51,0.63
91,Justin Schultz,PIT,D,78,12,39,51,0.65
92,Rickard Rakell,ANH,C,71,33,18,51,0.72
93,Patrick Eaves,ANH,RW,79,32,19,51,0.65
94,Jordan Eberle,EDM,RW,82,20,31,51,0.62
95,Alexander Steen,STL,LW,76,16,35,51,0.67
96,Nick Foligno,CLS,LW,79,26,25,51,0.65
97,Henrik Sedin,VAN,C,82,15,36,51,0.62
98,Jonathan Marchessault,FLA,C,75,30,21,51,0.68
99,Sam Gagner,CLS,C,81,18,32,50,0.62
100,Joe Thornton,SJ,C,79,7,43,50,0.63
101,Milan Lucic,EDM,LW,82,23,27,50,0.61
102,Dougie Hamilton,CGY,D,81,13,37,50,0.62
103,Jason Spezza,DAL,C,68,15,35,50,0.74
104,Jakob Silfverberg,ANH,RW,79,23,26,49,0.62
105,John Klingberg,DAL,D,80,13,36,49,0.61
106,Roman Josi,NSH,D,72,12,37,49,0.68
107,Sebastian Aho,CAR,RW,82,24,25,49,0.60
108,Kevin Hayes,NYR,C,76,17,32,49,0.64
109,Gustav Nyquist,DET,RW,76,12,36,48,0.63
110,Justin Williams,WAS,RW,80,24,24,48,0.60
111,Alex Pietrangelo,STL,D,80,14,34,48,0.60
112,Thomas Vanek,FLA,LW,68,17,31,48,0.71
113,Matthew Tkachuk,CGY,LW,76,13,35,48,0.63
114,Bryan Little,WPG,C,59,21,26,47,0.80
115,Jason Zucker,MIN,LW,79,22,25,47,0.59
116,Sam Reinhart,BUF,C,79,17,30,47,0.59
117,Jason Pominville,MIN,RW,78,13,34,47,0.60
118,Zach Werenski,CLS,D,78,11,36,47,0.60
119,Jaromir Jagr,FLA,RW,82,16,30,46,0.56
120,Patrick Marleau,SJ,LW,82,27,19,46,0.56
121,David Perron,STL,LW,82,18,28,46,0.56
122,Nick Leddy,NYI,D,81,11,35,46,0.57
123,Tomas Tatar,DET,LW,82,25,21,46,0.56
124,Rasmus Ristolainen,BUF,D,79,6,39,45,0.57
125,Brock Nelson,NYI,C,81,20,25,45,0.56
126,Marian Hossa,CHI,RW,73,26,19,45,0.62
127,Kyle Okposo,BUF,RW,65,19,26,45,0.69
128,Mathieu Perreault,WPG,C,65,13,32,45,0.69
129,Travis Zajac,NJ,C,80,14,31,45,0.56
130,Artem Anisimov,CHI,C,64,22,23,45,0.70
131,Victor Rask,CAR,C,82,16,29,45,0.55
132,Tyler Johnson,TB,C,66,19,26,45,0.68
133,Elias Lindholm,CAR,C,72,11,34,45,0.63
134,Jordan Staal,CAR,C,75,16,29,45,0.60
135,Drew Doughty,LA,D,82,12,32,44,0.54
136,Tanner Pearson,LA,LW,80,24,20,44,0.55
137,Alex Galchenyuk,MON,C,61,17,27,44,0.72
138,Michael Frolik,CGY,RW,82,17,27,44,0.54
139,Richard Panik,CHI,LW,82,22,22,44,0.54
140,Daniel Sedin,VAN,LW,82,15,29,44,0.54
141,Patric Hornqvist,PIT,RW,70,21,23,44,0.63
142,Paul Byron,MON,LW,81,22,21,43,0.53
143,Evander Kane,BUF,LW,70,28,15,43,0.61
144,Ryan Nugent-Hopkins,EDM,C,82,18,25,43,0.52
145,Jake Gardiner,TOR,D,82,9,34,43,0.52
146,Patrick Maroon,EDM,LW,81,27,15,42,0.52
147,Ryan McDonagh,NYR,D,77,6,36,42,0.55
148,Valtteri Filppula,PHI,C,79,12,30,42,0.53
149,Mike Fisher,NSH,C,72,18,24,42,0.58
150,Shea Weber,MON,D,78,17,25,42,0.54
151,Teuvo Teravainen,CAR,LW,81,15,27,42,0.52
152,Seth Jones,CLS,D,75,12,30,42,0.56
153,Zach Parise,MIN,LW,69,19,23,42,0.61
154,Brandon Dubinsky,CLS,C,80,12,29,41,0.51
155,Keith Yandle,FLA,D,82,5,36,41,0.50
156,Frans Nielsen,DET,C,79,17,24,41,0.52
157,Matt Duchene,COL,C,77,18,23,41,0.53
158,James Neal,NSH,RW,70,23,18,41,0.59
159,Phillip Danault,MON,LW,82,13,27,40,0.49
160,Michael Grabner,NYR,RW,76,27,13,40,0.53
161,Adam Henrique,NJ,C,82,20,20,40,0.49
162,Ryan Suter,MIN,D,82,9,31,40,0.49
163,Brayden Point,TB,C,68,18,22,40,0.59
164,Lee Stempniak,CAR,RW,82,16,24,40,0.49
165,P.K. Subban,NSH,D,66,10,30,40,0.61
166,Paul Stastny,STL,C,66,18,22,40,0.61
167,Brady Skjei,NYR,D,80,5,34,39,0.49
168,Mark Giordano,CGY,D,81,12,27,39,0.48
169,Derick Brassard,OTT,C,81,14,25,39,0.48
170,Martin Hanzal,MIN,C,71,20,19,39,0.55
171,Alec Martinez,LA,D,82,9,30,39,0.48
172,Ryan Spooner,BOS,C,78,11,28,39,0.50
173,Oliver Ekman-Larsson,ARI,D,79,12,27,39,0.49
174,Matt Niskanen,WAS,D,78,5,34,39,0.50
175,Cam Fowler,ANH,D,80,11,28,39,0.49
176,Brent Seabrook,CHI,D,79,3,36,39,0.49
177,Mikko Rantanen,COL,RW,75,20,19,39,0.52
178,Shayne Gostisbehere,PHI,D,76,7,32,39,0.51
179,David Backes,BOS,RW,74,17,21,38,0.51
180,Oscar Klefbom,EDM,D,82,12,26,38,0.46
181,Tyson Barrie,COL,D,74,7,31,38,0.51
182,Max Domi,ARI,LW,59,9,29,38,0.64
183,Jared Spurgeon,MIN,D,76,10,28,38,0.50
184,Ryan Ellis,NSH,D,71,16,22,38,0.54
185,Rick Nash,NYR,RW,67,23,15,38,0.57
186,Scott Hartnell,CLS,LW,78,13,24,37,0.47
187,Nick Bonino,PIT,C,80,18,19,37,0.46
188,Justin Faulk,CAR,D,75,17,20,37,0.49
189,Reilly Smith,FLA,RW,80,15,22,37,0.46
190,Kris Versteeg,CGY,RW,69,15,22,37,0.54
191,Mika Zibanejad,NYR,C,56,14,23,37,0.66
192,John Carlson,WAS,D,72,9,28,37,0.51
193,Nikita Zaitsev,TOR,D,82,4,32,36,0.44
194,Alex Killorn,TB,LW,81,19,17,36,0.44
195,T.J. Brodie,CGY,D,82,6,30,36,0.44
196,Connor Brown,TOR,RW,82,20,16,36,0.44
197,Anthony Mantha,DET,RW,60,17,19,36,0.60
198,Alex Goligoski,ARI,D,82,6,30,36,0.44
199,Mike Green,DET,D,72,14,22,36,0.50
200,Dustin Brown,LA,RW,80,14,22,36,0.45
201,Andrei Markov,MON,D,62,6,30,36,0.58
202,Colton Parayko,STL,D,81,4,31,35,0.43
203,Andrej Sekera,EDM,D,80,8,27,35,0.44
204,Colin Wilson,NSH,LW,70,12,23,35,0.50
205,Andre Burakovsky,WAS,LW,64,12,23,35,0.55
206,Andrew Cogliano,ANH,LW,82,16,19,35,0.43
207,Mark Letestu,EDM,C,78,16,19,35,0.45
208,Sven Baertschi,VAN,LW,68,18,17,35,0.51
209,Brian Gionta,BUF,RW,82,15,20,35,0.43
210,Brandon Sutter,VAN,C,81,17,17,34,0.42
211,Kris Letang,PIT,D,41,5,29,34,0.83
212,Nick Holden,NYR,D,80,11,23,34,0.43
213,Tobias Rieder,ARI,RW,80,16,18,34,0.43
214,Matt Dumba,MIN,D,76,11,23,34,0.45
215,Tyler Toffoli,LA,C,63,16,18,34,0.54
216,Patrik Berglund,STL,C,82,23,11,34,0.41
217,Boone Jenner,CLS,C,82,18,16,34,0.41
218,Sean Couturier,PHI,C,66,14,20,34,0.52
219,Jaccob Slavin,CAR,D,82,5,29,34,0.41
220,Jean-Gabriel Pageau,OTT,C,82,12,21,33,0.40
221,Jake Guentzel,PIT,C,40,16,17,33,0.83
222,Jason Chimera,NYI,LW,82,20,13,33,0.40
223,Christian Dvorak,ARI,C,78,15,18,33,0.42
224,Gabriel Landeskog,COL,LW,72,18,15,33,0.46
225,Jacob Trouba,WPG,D,60,8,25,33,0.55
226,Radek Faksa,DAL,C,80,12,21,33,0.41
227,Dmitry Orlov,WAS,D,82,6,27,33,0.40
228,Devin Shore,DAL,C,82,13,20,33,0.40
229,Dylan Larkin,DET,C,80,17,15,32,0.40
230,Zack Smith,OTT,C,74,16,16,32,0.43
231,Matt Moulson,BUF,LW,81,14,18,32,0.40
232,Leo Komarov,TOR,C,82,14,18,32,0.39
233,Ryan Dzingel,OTT,LW,81,14,18,32,0.40
234,Markus Granlund,VAN,C,69,19,13,32,0.46
235,Michael Cammalleri,NJ,LW,61,10,21,31,0.51
236,Andrew Ladd,NYI,LW,78,23,8,31,0.40
237,Matt Cullen,PIT,C,72,13,18,31,0.43
238,Calle Jarnkrok,NSH,C,81,15,16,31,0.38
239,Ryan Hartman,CHI,LW,76,19,12,31,0.41
240,Damon Severson,NJ,D,80,3,28,31,0.39
241,Alexandre Burrows,OTT,LW,75,15,16,31,0.41
242,Jay Beagle,WAS,RW,81,13,17,30,0.37
243,Ryan Strome,NYI,RW,69,13,17,30,0.43
244,Dion Phaneuf,OTT,D,81,9,21,30,0.37
245,Ivan Provorov,PHI,D,82,6,24,30,0.37
246,Robby Fabbri,STL,C,51,11,18,29,0.57
247,Josh Anderson,CLS,RW,78,17,12,29,0.37
248,Joel Ward,SJ,RW,78,10,19,29,0.37
249,Zdeno Chara,BOS,D,75,10,19,29,0.39
250,Craig Smith,NSH,RW,78,12,17,29,0.37
251,Derek Ryan,CAR,C,67,11,18,29,0.43
252,Adam Lowry,WPG,C,82,15,14,29,0.35
253,Chris Kunitz,PIT,LW,71,9,20,29,0.41
254,Andreas Athanasiou,DET,C,64,18,11,29,0.45
255,Andrew Shaw,MON,C,68,12,17,29,0.43
256,Brendan Gallagher,MON,RW,64,10,19,29,0.45
257,Noah Hanifin,CAR,D,81,4,25,29,0.36
258,Jake Muzzin,LA,D,82,9,19,28,0.34
259,Jason Demers,FLA,D,81,9,19,28,0.35
260,Nick Schmaltz,CHI,C,61,6,22,28,0.46
261,Jussi Jokinen,FLA,LW,69,11,17,28,0.41
262,P.A. Parenteau,NSH,RW,67,13,15,28,0.42
263,Jeff Petry,MON,D,80,8,20,28,0.35
264,Vladislav Namestnikov,TB,C,74,10,18,28,0.38
265,Travis Konecny,PHI,C,70,11,17,28,0.40
266,Antoine Vermette,ANH,C,72,9,19,28,0.39
267,Zach Hyman,TOR,C,82,10,18,28,0.34
268,Artturi Lehkonen,MON,LW,73,18,10,28,0.38
269,Tomas Plekanec,MON,C,78,10,18,28,0.36
270,Bryan Rust,PIT,RW,57,15,13,28,0.49
271,Marc-Edouard Vlasic,SJ,D,75,6,22,28,0.37
272,Nick Ritchie,ANH,LW,77,14,14,28,0.36
273,Nathan Beaulieu,MON,D,74,4,24,28,0.38
274,Shane Doan,ARI,RW,74,6,21,27,0.36
275,Jarome Iginla,LA,RW,80,14,13,27,0.34
276,Jimmy Vesey,NYR,LW,80,16,11,27,0.34
277,Morgan Rielly,TOR,D,76,6,21,27,0.36
278,Antoine Roussel,DAL,LW,60,12,15,27,0.45
279,Mark Streit,PIT,D,68,6,21,27,0.40
280,Ian Cole,PIT,D,81,5,21,26,0.32
281,Mikkel Boedker,SJ,LW,81,10,16,26,0.32
282,Jonathan Huberdeau,FLA,LW,31,10,16,26,0.84
283,Sam Bennett,CGY,C,81,13,13,26,0.32
284,Scott Wilson,PIT,LW,78,8,18,26,0.33
285,Paul Martin,SJ,D,81,4,22,26,0.32
286,Erik Haula,MIN,C,72,15,11,26,0.36
287,William Karlsson,CLS,C,81,6,19,25,0.31
288,Daniel Winnik,WAS,LW,72,12,13,25,0.35
289,Dominic Moore,BOS,C,82,11,14,25,0.30
290,Lars Eller,WAS,C,81,12,13,25,0.31
291,Bobby Ryan,OTT,RW,62,13,12,25,0.40
292,Brian Boyle,TOR,C,75,13,12,25,0.33
293,Micheal Ferland,CGY,LW,76,15,10,25,0.33
294,Casey Cizikas,NYI,C,59,8,17,25,0.42
295,Troy Brouwer,CGY,RW,74,13,12,25,0.34
296,Calvin de Haan,NYI,D,82,5,20,25,0.30
297,Mike Ribeiro,NSH,C,46,4,21,25,0.54
298,Jonas Brodin,MIN,D,68,3,22,25,0.37
299,Jordan Martinook,ARI,LW,77,11,14,25,0.32
300,Sami Vatanen,ANH,D,71,3,21,24,0.34
301,Trevor Lewis,LA,C,82,12,12,24,0.29
302,Colton Sceviour,FLA,C,80,9,15,24,0.30
303,Anthony Beauvillier,NYI,C,66,9,15,24,0.36
304,Loui Eriksson,VAN,LW,65,11,13,24,0.37
305,Alex Chiasson,CGY,RW,81,12,12,24,0.30
306,Zack Kassian,EDM,RW,79,7,17,24,0.30
307,Troy Stecher,VAN,D,71,3,21,24,0.34
308,Pavel Zacha,NJ,C,70,8,16,24,0.34
309,Brett Ritchie,DAL,RW,78,16,8,24,0.31
310,Mattias Ekholm,NSH,D,82,3,20,23,0.28
311,David Savard,CLS,D,74,6,17,23,0.31
312,Nikolay Kulemin,NYI,LW,72,12,11,23,0.32
313,Jack Johnson,CLS,D,82,5,18,23,0.28
314,Brett Connolly,WAS,RW,66,15,8,23,0.35
315,Matt Stajan,CGY,C,81,6,17,23,0.28
316,Tom Pyatt,OTT,LW,82,9,14,23,0.28
317,Radko Gudas,PHI,D,67,6,17,23,0.34
318,Marcus Foligno,BUF,LW,80,13,10,23,0.29
319,Mikhail Grigorenko,COL,C,75,10,13,23,0.31
320,Johnny Boychuk,NYI,D,66,6,17,23,0.35
321,Sven Andrighetto,COL,RW,46,7,16,23,0.50
322,Chris Tierney,SJ,C,80,11,12,23,0.29
323,Jori Lehtera,STL,C,64,7,15,22,0.34
324,Melker Karlsson,SJ,C,67,11,11,22,0.33
325,Carl Hagelin,PIT,LW,61,6,16,22,0.36
326,Dennis Seidenberg,NYI,D,73,5,17,22,0.30
327,Nic Dowd,LA,C,70,6,16,22,0.31
328,Tomas Hertl,SJ,C,49,10,12,22,0.45
329,John Moore,NJ,D,63,12,10,22,0.35
330,Anton Stralman,TB,D,73,5,17,22,0.30
331,Marian Gaborik,LA,RW,56,10,11,21,0.38
332,Justin Abdelkader,DET,LW,64,7,14,21,0.33
333,Drew Stafford,BOS,RW,58,8,13,21,0.36
334,Chris Stewart,MIN,RW,79,13,8,21,0.27
335,Aaron Ekblad,FLA,D,68,10,11,21,0.31
336,Alexander Edler,VAN,D,68,6,15,21,0.31
337,Jesper Fast,NYR,RW,68,6,15,21,0.31
338,Brendan Perlini,ARI,LW,57,14,7,21,0.37
339,Steven Stamkos,TB,C,17,9,11,20,1.18
340,Jakob Chychrun,ARI,D,68,7,13,20,0.29
341,Pavel Buchnevich,NYR,RW,41,8,12,20,0.49
342,Cal Clutterbuck,NYI,RW,66,5,15,20,0.30
343,Josh Morrissey,WPG,D,82,6,14,20,0.24
344,Hampus Lindholm,ANH,D,66,6,14,20,0.30
345,Oscar Lindberg,NYR,C,65,8,12,20,0.31
346,Lauri Korpikoski,CLS,LW,69,8,12,20,0.29
347,Jake McCabe,BUF,D,76,3,17,20,0.26
348,Jannik Hansen,SJ,RW,43,8,12,20,0.47
349,Brett Pesce,CAR,D,82,2,18,20,0.24
350,Blake Comeau,COL,LW,77,8,12,20,0.26
351,Kevin Labanc,SJ,RW,55,8,12,20,0.36
352,Thomas Hickey,NYI,D,76,4,16,20,0.26
353,Matt Read,PHI,RW,63,10,9,19,0.30
354,Ben Hutton,VAN,D,71,5,14,19,0.27
355,Matt Hunwick,TOR,D,72,1,18,19,0.26
356,Adam Larsson,EDM,D,79,4,15,19,0.24
357,Cody Franson,BUF,D,68,3,16,19,0.28
358,Tom Wilson,WAS,RW,82,7,12,19,0.23
359,Beau Bennett,NJ,RW,65,8,11,19,0.29
360,Trevor Daley,PIT,D,56,5,14,19,0.34
361,Joel Armia,WPG,RW,57,10,9,19,0.33
362,Drake Caggiula,EDM,LW,60,7,11,18,0.30
363,Francois Beauchemin,COL,D,81,5,13,18,0.22
364,Rene Bourque,COL,RW,65,12,6,18,0.28
365,Shane Prince,NYI,LW,50,5,13,18,0.36
366,Frank Vatrano,BOS,C,44,10,8,18,0.41
367,Andrew MacDonald,PHI,D,73,2,16,18,0.25
368,Patrick Sharp,DAL,LW,48,8,10,18,0.38
369,Brandon Pirri,NYR,RW,60,8,10,18,0.30
370,Scottie Upshall,STL,RW,73,10,8,18,0.25
371,Michael Del Zotto,PHI,D,51,6,12,18,0.35
372,David Schlemko,SJ,D,62,2,16,18,0.29
373,Derek Forbort,LA,D,82,2,16,18,0.22
374,Niklas Hjalmarsson,CHI,D,73,5,13,18,0.25
375,Esa Lindell,DAL,D,73,6,12,18,0.25
376,Alan Quine,NYI,C,61,5,13,18,0.30
377,Dennis Wideman,CGY,D,57,5,13,18,0.32
378,Josh Manson,ANH,D,82,5,12,17,0.21
379,Connor Murphy,ARI,D,77,2,15,17,0.22
380,Joonas Donskoi,SJ,RW,61,6,11,17,0.28
381,Marcus Kruger,CHI,C,70,5,12,17,0.24
382,Ron Hainsey,PIT,D,72,4,13,17,0.24
383,Darren Helm,DET,C,50,8,9,17,0.34
384,Riley Nash,BOS,C,81,7,10,17,0.21
385,Jordie Benn,MON,D,71,4,13,17,0.24
386,Chris Wideman,OTT,D,76,5,12,17,0.22
387,Brian Campbell,CHI,D,80,5,12,17,0.21
388,Torrey Mitchell,MON,C,78,8,9,17,0.22
389,Cody Ceci,OTT,D,79,2,15,17,0.22
390,Nick Shore,LA,C,70,6,11,17,0.24
391,Austin Watson,NSH,LW,77,5,12,17,0.22
392,Nikita Nesterov,MON,D,48,4,13,17,0.35
393,Miles Wood,NJ,LW,60,8,9,17,0.28
394,Nate Schmidt,WAS,D,60,3,14,17,0.28
395,Jamie McGinn,ARI,LW,72,9,8,17,0.24
396,Andrew Copp,WPG,C,64,9,8,17,0.27
397,Mark Pysyk,FLA,D,82,4,13,17,0.21
398,Erik Johnson,COL,D,46,2,15,17,0.37
399,Michael Matheson,FLA,D,81,7,10,17,0.21
400,Tom Kuhnhackl,PIT,RW,57,4,12,16,0.28
401,Adam Cracknell,DAL,RW,69,10,6,16,0.23
402,Derek MacKenzie,FLA,C,82,6,10,16,0.20
403,Trevor van Riemsdyk,CHI,D,58,5,11,16,0.28
404,Nick Cousins,PHI,C,60,6,10,16,0.27
405,Alex Burmistrov,ARI,C,49,5,11,16,0.33
406,Brock McGinn,CAR,LW,57,7,9,16,0.28
407,Zemgus Girgensons,BUF,C,75,7,9,16,0.21
408,Tanner Kero,CHI,C,47,6,10,16,0.34
409,Brandon Carlo,BOS,D,82,6,10,16,0.20
410,Viktor Stalberg,OTT,LW,75,11,5,16,0.21
411,Ryan White,MIN,C,65,9,7,16,0.25
412,Deryk Engelland,CGY,D,81,4,12,16,0.20
413,Kevin Fiala,NSH,LW,54,11,5,16,0.30
414,Dan Hamhuis,DAL,D,79,1,15,16,0.20
415,Dwight King,MON,LW,80,9,7,16,0.20
416,Curtis McKenzie,DAL,LW,53,6,10,16,0.30
417,Kyle Brodziak,STL,C,69,8,7,15,0.22
418,Anthony Duclair,ARI,LW,58,5,10,15,0.26
419,Ondrej Kase,ANH,RW,53,5,10,15,0.28
420,Jay Bouwmeester,STL,D,81,1,14,15,0.19
421,Chris VandeVelde,PHI,C,81,6,9,15,0.19
422,Brian Dumoulin,PIT,D,70,1,14,15,0.21
423,Dan Girardi,NYR,D,63,4,11,15,0.24
424,Matt Benning,EDM,D,62,3,12,15,0.24
425,Matt Calvert,CLS,LW,65,10,5,15,0.23
426,Dale Weise,PHI,RW,64,8,7,15,0.23
427,Joel Edmundson,STL,D,69,3,12,15,0.22
428,Kyle Quincey,CLS,D,73,6,9,15,0.21
429,Michael Stone,CGY,D,64,3,12,15,0.23
430,Anthony DeAngelo,ARI,D,39,5,9,14,0.36
431,Luke Glendening,DET,C,74,3,11,14,0.19
432,Benoit Pouliot,EDM,LW,67,8,6,14,0.21
433,Alex Petrovic,FLA,D,49,1,13,14,0.29
434,Brooks Orpik,WAS,D,79,0,14,14,0.18
435,Carl Soderberg,COL,C,80,6,8,14,0.18
436,Andrej Sustr,TB,D,80,3,11,14,0.18
437,Travis Hamonic,NYI,D,49,3,11,14,0.29
438,Kevin Klein,NYR,D,60,3,11,14,0.23
439,Vinnie Hinostroza,CHI,LW,49,6,8,14,0.29
440,Matt Irwin,NSH,D,74,3,11,14,0.19
441,Paul Postma,WPG,D,65,1,13,14,0.22
442,David Desharnais,EDM,C,49,6,8,14,0.29
443,Tim Schaller,BOS,C,59,7,7,14,0.24
444,Nick Bjugstad,FLA,C,54,7,7,14,0.26
445,Toby Enstrom,WPG,D,60,1,13,14,0.23
446,Kevin Bieksa,ANH,D,81,3,11,14,0.17
447,Karl Alzner,WAS,D,82,3,10,13,0.16
448,Ryan Reaves,STL,RW,80,7,6,13,0.16
449,Andy Greene,NJ,D,66,4,9,13,0.20
450,Niklas Kronwall,DET,D,57,2,11,13,0.23
451,Nic Petan,WPG,LW,54,1,12,13,0.24
452,Nick Jensen,DET,D,49,4,9,13,0.27
453,Colin Miller,BOS,D,61,6,7,13,0.21
454,Fedor Tyutin,COL,D,69,1,12,13,0.19
455,Oliver Bjorkstrand,CLS,RW,26,6,7,13,0.50
456,Luca Sbisa,VAN,D,82,2,11,13,0.16
457,Magnus Paajarvi,STL,LW,32,8,5,13,0.41
458,Tyler Ennis,BUF,LW,51,5,8,13,0.25
459,Mark Barberio,COL,D,60,2,11,13,0.22
460,Marco Scandella,MIN,D,71,4,9,13,0.18
461,Kris Russell,EDM,D,68,1,12,13,0.19
462,Kevan Miller,BOS,D,58,3,10,13,0.22
463,Austin Czarnik,BOS,C,49,5,8,13,0.27
464,Justin Braun,SJ,D,81,4,9,13,0.16
465,Riley Sheahan,DET,C,80,2,11,13,0.16
466,Jordan Schroeder,MIN,C,37,6,7,13,0.35
467,Matt Nieto,COL,LW,59,7,6,13,0.22
468,Lukas Sedlak,CLS,C,62,7,6,13,0.21
469,Brandon Manning,PHI,D,65,3,9,12,0.18
470,Cody Eakin,DAL,C,60,3,9,12,0.20
471,Josh Jooris,ARI,C,54,4,8,12,0.22
472,Devin Setoguchi,LA,RW,45,4,8,12,0.27
473,Shawn Matthias,WPG,LW,45,8,4,12,0.27
474,Patrick Wiercioch,COL,D,57,4,8,12,0.21
475,Kyle Clifford,LA,LW,73,6,6,12,0.16
476,Ivan Barbashev,STL,C,30,5,7,12,0.40
477,Micheal Haley,SJ,C,58,2,10,12,0.21
478,Jordan Weal,PHI,C,23,8,4,12,0.52
479,Danny DeKeyser,DET,D,82,4,8,12,0.15
480,Peter Holland,ARI,C,48,5,7,12,0.25
481,Braydon Coburn,TB,D,80,5,7,12,0.15
482,Ben Chiarot,WPG,D,59,2,10,12,0.20
483,Tommy Wingels,OTT,C,73,7,5,12,0.16
484,Xavier Ouellet,DET,D,66,3,9,12,0.18
485,Joakim Nordstrom,CAR,LW,82,7,5,12,0.15
486,Lawson Crouse,ARI,LW,72,5,7,12,0.17
487,Chris Kelly,OTT,C,82,5,7,12,0.15
488,Marc Methot,OTT,D,68,0,12,12,0.18
489,Zach Bogosian,BUF,D,56,2,9,11,0.20
490,Tyler Pitlick,EDM,RW,31,8,3,11,0.35
491,Ryan Murray,CLS,D,60,2,9,11,0.18
492,Johan Larsson,BUF,C,36,6,5,11,0.31
493,Roman Polak,TOR,D,75,4,7,11,0.15
494,Fredrik Claesson,OTT,D,33,3,8,11,0.33
495,Jake Dotchin,TB,D,35,0,11,11,0.31
496,Michael Raffl,PHI,LW,52,8,3,11,0.21
497,Adam Clendening,NYR,D,31,2,9,11,0.35
498,Marko Dano,WPG,C,38,4,7,11,0.29
499,Dmitrij Jaskin,STL,RW,51,1,10,11,0.22
500,Jiri Hudler,DAL,RW,32,3,8,11,0.34
501,Eric Fehr,TOR,C,53,6,5,11,0.21
502,Darnell Nurse,EDM,D,44,5,6,11,0.25
503,Chad Ruhwedel,PIT,D,34,2,8,10,0.29
504,Adam Pelech,NYI,D,44,3,7,10,0.23
505,Stefan Noesen,NJ,RW,44,8,2,10,0.23
506,Reid Boucher,VAN,C,39,6,4,10,0.26
507,Nikita Zadorov,COL,D,56,0,10,10,0.18
508,Denis Malgin,FLA,C,47,6,4,10,0.21
509,Alexei Emelin,MON,D,76,2,8,10,0.13
510,Joseph Cramarossa,VAN,C,59,4,6,10,0.17
511,Joshua Ho-Sang,NYI,RW,21,4,6,10,0.48
512,Marc Staal,NYR,D,72,3,7,10,0.14
513,Anton Slepyshev,EDM,LW,41,4,6,10,0.24
514,Cedric Paquette,TB,C,58,4,6,10,0.17
515,Brian Flynn,MON,C,51,6,4,10,0.20
516,Stephen Johns,DAL,D,61,4,6,10,0.16
517,Logan Shaw,ANH,C,55,3,7,10,0.18
518,Colton Sissons,NSH,C,58,8,2,10,0.17
519,Brenden Dillon,SJ,D,81,2,8,10,0.12
520,Adam McQuaid,BOS,D,77,2,8,10,0.13
521,Christopher Tanev,VAN,D,53,2,8,10,0.19
522,Josh Leivo,TOR,LW,13,2,8,10,0.77
523,Jacob Josefson,NJ,C,38,1,9,10,0.26
524,Jason Garrison,TB,D,70,1,8,9,0.13
525,Matt Puempel,NYR,LW,40,6,3,9,0.23
526,Nail Yakupov,STL,RW,40,3,6,9,0.23
527,Greg Pateryn,DAL,D,36,1,8,9,0.25
528,Matt Martin,TOR,LW,82,5,4,9,0.11
529,Jack Skille,VAN,RW,55,5,4,9,0.16
530,Jonathan Ericsson,DET,D,51,1,8,9,0.18
531,Brendan Smith,NYR,D,51,3,6,9,0.18
532,Devante Smith-Pelly,NJ,RW,53,4,5,9,0.17
533,Michael Sgarbossa,FLA,C,38,2,7,9,0.24
534,Nikita Soshnikov,TOR,RW,56,5,4,9,0.16
535,Nikita Tryamkin,VAN,D,66,2,7,9,0.14
536,Joseph Blandisi,NJ,LW,27,3,6,9,0.33
537,Scott Mayfield,NYI,D,25,2,7,9,0.36
538,Shea Theodore,ANH,D,34,2,7,9,0.26
539,Tyler Graovac,MIN,C,52,7,2,9,0.17
540,Daniel Carr,MON,LW,33,2,7,9,0.27
541,Brad Richardson,ARI,RW,16,5,4,9,0.56
542,Johnny Oduya,CHI,D,52,2,7,9,0.17
543,Yanni Gourde,TB,C,20,6,2,8,0.40
544,Jay McClement,CAR,C,65,5,3,8,0.12
545,Connor Carrick,TOR,D,67,2,6,8,0.12
546,Michal Kempny,CHI,D,50,2,6,8,0.16
547,Justin Falk,BUF,D,52,0,8,8,0.15
548,Jordan Nolan,LA,C,46,4,4,8,0.17
549,Luke Schenn,ARI,D,78,1,7,8,0.10
550,Jayson Megna,VAN,C,58,4,4,8,0.14
551,Dylan DeMelo,SJ,D,25,1,7,8,0.32
552,Dennis Rasmussen,CHI,C,68,4,4,8,0.12
553,Joe Colborne,COL,C,62,4,4,8,0.13
554,Pierre-Edouard Bellemare,PHI,LW,82,4,4,8,0.10
555,Christian Folin,MIN,D,51,2,6,8,0.16
556,Matt Beleskey,BOS,LW,49,3,5,8,0.16
557,William Carrier,BUF,LW,41,5,3,8,0.20
558,Zach Sanford,STL,LW,39,4,4,8,0.21
559,Jesse Puljujarvi,EDM,RW,28,1,7,8,0.29
560,Alexey Marchenko,TOR,D,41,1,7,8,0.20
561,Yannick Weber,NSH,D,73,1,7,8,0.11
562,Paul LaDue,LA,D,22,0,8,8,0.36
563,Michael Chaput,VAN,C,68,4,4,8,0.12
564,Remi Elie,DAL,LW,18,1,6,7,0.39
565,Steven Santini,NJ,D,38,2,5,7,0.18
566,Ryan Sproul,DET,D,27,1,6,7,0.26
567,Drew Miller,DET,LW,55,5,2,7,0.13
568,Nate Prosser,MIN,D,39,2,5,7,0.18
569,Steve Ott,MON,C,53,3,4,7,0.13
570,Nick Lappin,NJ,RW,43,4,3,7,0.16
571,Joel Eriksson Ek,MIN,C,15,3,4,7,0.47
572,Carter Rowney,PIT,RW,27,3,4,7,0.26
573,Lance Bouma,CGY,C,61,3,4,7,0.11
574,Jared McCann,FLA,C,29,1,6,7,0.24
575,Tyler Motte,CHI,LW,33,4,3,7,0.21
576,Phillip Di Giuseppe,CAR,LW,36,1,6,7,0.19
577,Chris Wagner,ANH,C,43,6,1,7,0.16
578,Ales Hemsky,DAL,RW,15,4,3,7,0.47
579,Markus Nutivaara,CLS,D,66,2,5,7,0.11
580,Matt Hendricks,EDM,LW,42,4,3,7,0.17
581,Martin Marincin,TOR,D,25,1,6,7,0.28
582,Greg McKegg,TB,C,46,3,4,7,0.15
583,Korbinian Holzer,ANH,D,32,2,5,7,0.22
584,John Mitchell,COL,C,65,3,4,7,0.11
585,Kevin Gravel,LA,D,49,1,6,7,0.14
586,Taylor Fedun,BUF,D,27,0,7,7,0.26
587,Jamie Oleksiak,DAL,D,41,5,2,7,0.17
588,Olli Maatta,PIT,D,55,1,6,7,0.13
589,Ben Lovejoy,NJ,D,82,1,6,7,0.09
590,Anthony Bitetto,NSH,D,29,0,7,7,0.24
591,Andreas Martinsen,MON,LW,64,3,4,7,0.11
592,Roman Lyubimov,PHI,LW,47,4,2,6,0.13
593,Carl Gunnarsson,STL,D,56,0,6,6,0.11
594,Cody McLeod,NSH,LW,59,5,1,6,0.10
595,Brandon Montour,ANH,D,27,2,4,6,0.22
596,Erik Gudbranson,VAN,D,30,1,5,6,0.20
597,Jon Merrill,NJ,D,51,1,5,6,0.12
598,Adrian Kempe,LA,LW,25,2,4,6,0.24
599,J.T. Brown,TB,RW,64,3,3,6,0.09
600,Eric Gryba,EDM,D,40,2,4,6,0.15
601,Gemel Smith,DAL,C,17,3,3,6,0.35
602,Matt Tennyson,CAR,D,45,0,6,6,0.13
603,Jyrki Jokipakka,OTT,D,41,1,5,6,0.15
604,Klas Dahlbeck,CAR,D,43,2,4,6,0.14
605,Stephen Gionta,NYI,RW,26,1,5,6,0.23
606,Dalton Prout,NJ,D,29,0,6,6,0.21
607,Evan Rodrigues,BUF,LW,30,4,2,6,0.20
608,Philip Larsen,VAN,D,26,1,5,6,0.23
609,Timo Meier,SJ,RW,34,3,3,6,0.18
610,Brad Hunt,NSH,D,12,1,5,6,0.50
611,Josh Gorges,BUF,D,66,1,5,6,0.09
612,Jakub Vrana,WAS,LW,21,3,3,6,0.29
613,Garnet Hathaway,CGY,RW,26,1,4,5,0.19
614,Brendan Gaunce,VAN,C,57,0,5,5,0.09
615,Cody Goloubef,COL,D,33,0,5,5,0.15
616,Kyle Connor,WPG,LW,20,2,3,5,0.25
617,Jimmy Hayes,BOS,RW,58,2,3,5,0.09
618,Zach Redmond,MON,D,16,0,5,5,0.31
619,Noel Acciari,BOS,C,29,2,3,5,0.17
620,Brock Boeser,VAN,RW,9,4,1,5,0.56
621,Tom Gilbert,WAS,D,18,1,4,5,0.28
622,Andrej Nestrasil,CAR,C,19,1,4,5,0.26
623,Tyler Myers,WPG,D,11,2,3,5,0.45
624,Gustav Forsling,CHI,D,38,2,3,5,0.13
625,Michael McCarron,MON,RW,31,1,4,5,0.16
626,Dmitry Kulikov,BUF,D,47,2,3,5,0.11
627,Taylor Chorney,WAS,D,18,1,4,5,0.28
628,John-Michael Liles,BOS,D,36,0,5,5,0.14
629,J.T. Compher,COL,LW,21,3,2,5,0.24
630,Seth Griffith,TOR,C,24,0,5,5,0.21
631,Julius Honka,DAL,D,16,1,4,5,0.31
632,Cameron Gaunce,PIT,D,12,1,3,4,0.33
633,John Hayden,CHI,LW,12,1,3,4,0.33
634,Gabriel Dumont,TB,C,39,2,2,4,0.10
635,Nick Schultz,PHI,D,28,0,4,4,0.14
636,Marcus Sorensen,SJ,RW,19,1,3,4,0.21
637,Ryan Callahan,TB,RW,18,2,2,4,0.22
638,Sergey Kalinin,TOR,C,43,2,2,4,0.09
639,Vernon Fiddler,NSH,C,59,2,2,4,0.07
640,Curtis Lazar,CGY,C,37,1,3,4,0.11
641,Robert Bortuzzo,STL,D,38,1,3,4,0.11
642,Yohann Auvitu,NJ,D,25,2,2,4,0.16
643,Ryan Carpenter,SJ,C,11,2,2,4,0.36
644,Justin Bailey,BUF,RW,32,2,2,4,0.13
645,Mark Stuart,WPG,D,42,2,2,4,0.10
646,Brandon Tanev,WPG,LW,51,2,2,4,0.08
647,John Quenneville,NJ,C,12,1,3,4,0.33
648,Iiro Pakarinen,EDM,RW,14,2,2,4,0.29
649,Jakub Kindl,FLA,D,39,0,4,4,0.10
650,Brayden McNabb,LA,D,49,2,2,4,0.08
651,Slater Koekkoek,TB,D,29,0,4,4,0.14
652,Chris Terry,MON,LW,14,2,2,4,0.29
653,Cory Conacher,TB,C,11,1,3,4,0.36
654,Shawn Thornton,FLA,LW,50,2,2,4,0.08
655,Luke Witkowski,TB,D,34,0,4,4,0.12
656,Chris Thorburn,WPG,RW,64,3,1,4,0.06
657,Ben Smith,TOR,RW,40,2,2,4,0.10
658,Derek Dorsett,VAN,RW,14,1,3,4,0.29
659,Chris Neil,OTT,RW,53,1,3,4,0.08
660,Harry Zolnierczyk,NSH,LW,24,2,2,4,0.17
661,Anton Lander,EDM,C,22,1,3,4,0.18
662,Derek Grant,BUF,C,46,0,4,4,0.09
663,Nicholas Baptiste,BUF,RW,14,3,1,4,0.29
664,Karl Stollery,NJ,D,11,0,3,3,0.27
665,Shane Harper,NJ,RW,14,2,1,3,0.21
666,Joel Vermin,TB,RW,18,0,3,3,0.17
667,Paul Thompson,FLA,RW,21,0,3,3,0.14
668,Gustav Olofsson,MIN,D,13,0,3,3,0.23
669,Zac Dalpe,CLS,C,9,1,2,3,0.33
670,Josh Archibald,PIT,RW,10,3,0,3,0.30
671,Nikolay Goldobin,VAN,RW,14,3,0,3,0.21
672,Scott Harrington,CLS,D,22,1,2,3,0.14
673,Frederik Gauthier,TOR,C,21,2,1,3,0.14
674,Alex Biega,VAN,D,36,0,3,3,0.08
675,Patrik Nemeth,DAL,D,40,0,3,3,0.08
676,Brett Kulak,CGY,D,21,0,3,3,0.14
677,Ryan Garbutt,ANH,C,27,2,1,3,0.11
678,Christian Fischer,ARI,RW,7,3,0,3,0.43
679,Jordin Tootoo,CHI,RW,50,2,1,3,0.06
680,Michal Rozsival,CHI,D,22,1,2,3,0.14
681,Clayton Stoner,ANH,D,14,1,2,3,0.21
682,Kenny Agostino,STL,LW,7,1,2,3,0.43
683,Michael Bournival,TB,LW,19,2,1,3,0.16
684,Jared Boll,ANH,RW,51,0,3,3,0.06
685,Adam Erne,TB,LW,26,3,0,3,0.12
686,Brandon Davidson,MON,D,38,0,3,3,0.08
687,Mark Borowiecki,OTT,D,70,1,2,3,0.04
688,Kyle Rau,FLA,C,24,2,1,3,0.13
689,Laurent Dauphin,ARI,C,24,2,1,3,0.13
690,Matt Murray,PIT,G,49,0,2,2,0.04
691,Anton Blidh,BOS,LW,19,1,1,2,0.11
692,Jordan Schmaltz,STL,D,9,0,2,2,0.22
693,Matt Bartkowski,CGY,D,24,1,1,2,0.08
694,Lucas Wallmark,CAR,C,8,0,2,2,0.25
695,Brian Strait,WPG,D,5,0,2,2,0.40
696,Nicolas Deslauriers,BUF,LW,42,0,2,2,0.05
697,Teemu Pulkkinen,ARI,LW,13,2,0,2,0.15
698,Drew Shore,VAN,C,14,0,2,2,0.14
699,Matt Greene,LA,D,26,1,1,2,0.08
700,Mirco Mueller,SJ,D,4,1,1,2,0.50
701,Al Montoya,MON,G,19,0,2,2,0.11
702,Pontus Aberg,NSH,LW,15,1,1,2,0.13
703,Steven Kampfer,NYR,D,11,1,1,2,0.18
704,Mark Fayne,EDM,D,4,0,2,2,0.50
705,Justin Dowling,DAL,C,9,0,2,2,0.22
706,Ty Rattie,STL,RW,9,0,2,2,0.22
707,Freddie Hamilton,CGY,C,26,2,0,2,0.08
708,Peter Cehlarik,BOS,LW,11,0,2,2,0.18
709,Tuukka Rask,BOS,G,65,0,2,2,0.03
710,Milan Michalek,TOR,LW,5,1,1,2,0.40
711,Jonny Brodzinski,LA,C,6,0,2,2,0.33
712,Calvin Pickard,COL,G,50,0,2,2,0.04
713,Blake Coleman,NJ,C,23,1,1,2,0.09
714,Jason Dickinson,DAL,C,10,2,0,2,0.20
715,Tom Sestito,PIT,LW,13,0,2,2,0.15
716,Taylor Leier,PHI,LW,10,1,1,2,0.20
717,Matthew Peca,TB,C,10,1,1,2,0.20
718,Andy Andreoff,LA,LW,36,0,2,2,0.06
719,Nate Thompson,ANH,C,30,1,1,2,0.07
720,Tanner Glass,NYR,LW,11,1,1,2,0.18
721,Charles Hudon,MON,LW,3,0,2,2,0.67
722,Ryan Murphy,CAR,D,27,0,2,2,0.07
723,Markus Hannikainen,CLS,LW,10,1,1,2,0.20
724,Andrei Vasilevskiy,TB,G,50,0,2,2,0.04
725,Clayton Keller,ARI,C,3,0,2,2,0.67
726,Julian Melchiori,WPG,D,18,0,2,2,0.11
727,Teddy Purcell,LA,LW,12,0,2,2,0.17
728,Marek Hrivik,NYR,LW,16,0,2,2,0.13
729,Jujhar Khaira,EDM,LW,10,1,0,1,0.10
730,Matt Lorito,DET,LW,2,0,1,1,0.50
731,Anton Rodin,VAN,RW,3,0,1,1,0.33
732,Cole Schneider,BUF,LW,4,0,1,1,0.25
733,Daniel O'Regan,SJ,C,3,1,0,1,0.33
734,Henrik Lundqvist,NYR,G,57,0,1,1,0.02
735,Mike Reilly,MIN,D,17,1,0,1,0.06
736,Joe Morrow,BOS,D,17,0,1,1,0.06
737,Frederik Andersen,TOR,G,66,0,1,1,0.02
738,Nick Sorensen,ANH,RW,5,0,1,1,0.20
739,Vladimir Sobotka,STL,C,1,1,0,1,1.00
740,Kasperi Kapanen,TOR,RW,8,1,0,1,0.13
741,Hudson Fasching,BUF,RW,10,0,1,1,0.10
742,Jake Allen,STL,G,61,0,1,1,0.02
743,Peter Budaj,TB,G,60,0,1,1,0.02
744,David Warsofsky,PIT,D,7,0,1,1,0.14
745,Kurtis Gabriel,MIN,RW,13,0,1,1,0.08
746,Carter Hutton,STL,G,30,0,1,1,0.03
747,Steve Oleksy,TOR,D,11,0,1,1,0.09
748,Carey Price,MON,G,62,0,1,1,0.02
749,Michael Leighton,CAR,G,4,0,1,1,0.25
750,Eric Gelinas,COL,D,27,0,1,1,0.04
751,Nikita Scherbak,MON,RW,3,1,0,1,0.33
752,Seth Helgeson,NJ,D,9,1,0,1,0.11
753,Kari Lehtonen,DAL,G,59,0,1,1,0.02
754,Cal O'Reilly,BUF,C,11,0,1,1,0.09
755,Sergey Tolchinsky,CAR,LW,2,0,1,1,0.50
756,Roberto Luongo,FLA,G,40,0,1,1,0.03
757,Ryan Miller,VAN,G,54,0,1,1,0.02
758,Wade Megan,STL,C,3,1,0,1,0.33
759,Christoph Bertschy,MIN,C,5,0,1,1,0.20
760,Robin Lehner,BUF,G,59,0,1,1,0.02
761,Gabriel Carlsson,CLS,D,2,0,1,1,0.50
762,Ben Street,DET,C,6,0,1,1,0.17
763,Thomas Greiss,NYI,G,51,0,1,1,0.02
764,Hunter Shinkaruk,CGY,C,7,0,1,1,0.14
765,Blake Pietila,NJ,LW,10,0,1,1,0.10
766,Rocco Grimaldi,COL,C,4,0,1,1,0.25
767,Tomas Nosek,DET,LW,11,1,0,1,0.09
768,Antti Raanta,NYR,G,30,0,1,1,0.03
769,Darcy Kuemper,MIN,G,18,0,1,1,0.06
770,Semyon Varlamov,COL,G,24,0,1,1,0.04
771,C.J. Smith,BUF,LW,2,0,1,1,0.50
772,Anton Khudobin,BOS,G,16,0,1,1,0.06
773,Dylan McIlrath,DET,D,6,1,0,1,0.17
774,Tomas Jurco,CHI,LW,29,1,0,1,0.03
775,Sean Kuraly,BOS,C,8,0,1,1,0.13
776,Matt Carle,NSH,D,6,0,1,1,0.17
777,Samuel Henley,COL,C,1,1,0,1,1.00
778,John Gibson,ANH,G,52,0,1,1,0.02
779,Dylan Strome,ARI,C,7,0,1,1,0.14
780,Cam Ward,CAR,G,61,0,1,1,0.02
781,Boyd Gordon,PHI,C,13,1,0,1,0.08
782,Bryan Bickell,CAR,LW,11,1,0,1,0.09
783,Colin McDonald,PHI,RW,3,1,0,1,0.33
784,Jake Virtanen,VAN,RW,10,0,1,1,0.10
785,Corey Crawford,CHI,G,55,0,1,1,0.02
786,Juuse Saros,NSH,G,21,0,1,1,0.05
787,Ian McCoshen,FLA,D,3,0,1,1,0.33
788,Craig Anderson,OTT,G,40,0,1,1,0.03
789,Keith Kinkaid,NJ,G,26,0,1,1,0.04
790,Barclay Goodrow,SJ,RW,3,0,1,1,0.33
791,Marek Mazanec,NSH,G,4,0,1,1,0.25
792,A.J. Greer,COL,LW,5,0,1,1,0.20
793,Alexander Nylander,BUF,RW,4,0,1,1,0.25
794,Frederick Gaudreau,NSH,C,9,0,1,1,0.11
795,Kevin Connauton,ARI,D,24,0,1,1,0.04
796,Dominik Simon,PIT,C,2,0,1,1,0.50
797,Steve Mason,PHI,G,58,0,1,1,0.02
798,Jaroslav Halak,NYI,G,28,0,1,1,0.04
799,Tyson Jost,COL,C,6,1,0,1,0.17
800,Valentin Zykov,CAR,LW,2,1,0,1,0.50
801,Andrew Desjardins,CHI,LW,46,0,1,1,0.02
802,Tyler Gaudet,ARI,C,4,0,1,1,0.25
